00000000000111111111
11111111110111111111
11111111110111111111
11111111110000000000
11111111111111111110
11111111111111111110
11111111111111111110
00000000000000000000
01111111111111111111
01111111111111111111
01111111111111111111
01111111111111111111
00000000000000000000
